1111111111111111
10000000000000c1
1010011111111011
1000010000000010
1010011111111111
1m00010000001000
1111111111111111