1111111111111111
1000000000000001
1010011111111011
1000010000000010
1010011111111c11
1m00010000001000
1111111111111111