1111111111111111111111111111111111111111111111111111111111111111111
1000000000000000000000000000000000000000000000000000000000000000001
1010011111111011101001111101100101111011010011111011011100100001101
100001c1000000101101001000001000101001001000001000101011101100001101
1010010111111011101011011111101101101011011111111011101000000000001101
1m0001000000000101101001000001000101001001000001000101001111111111101
1111111111111111111111111111111111111111111111111111111111111111111111
