11111111111111111111
1m010000010100000001
10001111111000111111
10000100011000010001
11101101011110110101
10000000011000000001
11111111011011111001
10000001011000001001
1110010101100101c111
11111111111111111111